11100000000000000110000000000000
02011100000000000201110000000000
22000000000011102200000000001110
22000000010000002200000001000000
02021001011100100202100101110010
02001000000110000200105500011000
22020000000010000123456810001000
02200000000000100220000000000010
02000000000000100200000000000010
02222222000000100222222200000010
